18 9
0 0
3 3 3 3 3 3 3 3 3 3 3 3 3 3 3 3 3 3
1 2 1 0 1 1 2 1 0 1 1 2 1 0 1 1 2 1
1 1 1 2 1 1 2 1 0 1 1 2 1 0 1 1 2 1
1 0 0 1 1 1 0 0 1 1 1 0 0 1 1 1 0 0
1 1 2 1 1 0 0 1 1 1 0 0 1 1 1 0 0 1
1 1 1 1 1 0 1 1 1 0 0 1 1 1 0 1 2 1
1 1 2 1 1 0 0 1 1 1 0 0 1 1 1 0 0 1
1 1 1 2 1 1 2 1 0 1 1 2 1 0 1 1 2 1
4 4 4 4 4 4 4 4 4 4 4 4 4 4 4 4 4 4